Collected cryptowallet extensions:

MetaMask - "nkbihfbeogaeaoehlefnkodbefgpgknn"
MetaMask Edge - "ejbalbakoplchlghecdalmeeeajnimhm"
MetaMask OperaGX - "djclckkglechooblngghdinmeemkbgci"
Ronin - "fnjhmkhhmkbjkkabndcnnogagogbneec"
Ronin Edge - "kjmoohlgokccodicjjfebfomlbljgfhk"
TronLink - "ibnejdfjmmkpcnlpebklmnkoeoihofec"
Liquality - "kpfopkelmapcoipemfendmdcghnegimn"
Keplr - "dmkamcknogkgcdfhhbddcghachkejeap"
Keplr Edge - "efknohjclbjfppcmniflbmnokbihoofp"
NeoLine - "cphhlgmgameodnhkjdmkpanlelnlohao"
Polymesh - "jojhfeoedkpkglbfimdfabpdfjaoolaf"
Clover - "nhnkbkgjikgcigadomkphalanndcapjk"
Sollet - "fhmfendgdocmcbmfikdcogofphimnkno"
ICONex - "flpiciilemghbmfalicajoolhkkenfel"
Temple - "ookjlbkiijinhpmnjffcofjonbfbgaoc"
Coin98 - "aeachknmefphepccionboohckonoeemg"
Auro - "cnmamaachppnkjgnildpdmkaakejnhae"
Cyano - "dkdedlpgdmmkkfjabffeganieamfklkm"
SafePal - "lgmpcpglpngdoalbgeoldeajfclnhafa"
SafePal Edge - "apenkfbbpmhihehmihndmmcdanacolnh"
Binance Chain - "fhbohimaelbohpjbbldcngcnapndodjp"
Trust Wallet - "egjidjbpglichdcondbcbdnbeeppgdph"
Phantom - "bfnaelmomeimhlpmgjnjophhpkkoljpa"
Solflare - "bhhhlbepdkbapadjdnnojkbgioiodbic"
MultiversX - "dngmlblcodfobpdpecaadgfbcggfjfnm"
MetaWallet - "bkklifkecemccedpkhcebagjpehhabfb"
MetaWallet Edge - "kfocnlddfahihoalinnfbnfmopjokmhl"
XDEFI - "hmeobnfnfcmdkdcmlblgagmfpfboieaf"
OKX - "mcohilncbfahbmgdjkbpemcciiolgcge"
OKX Edge - "pbpjkcldjiffchgbbndmhojiacbgflha"
iWallet - "kncchdigobghenbbaddojjnnaogfppfj"
Math - "afbcbjpbpfadlkmhmclhkeeodmamcflc"
Math Edge - "dfeccadlilpndjjohbjdblepmjeahlmm"
Wombat - "amkmjjmmflddogmhpjloimipbofnfjih"
Cradle - "ppgbdgcacdkfilmdgjlcmigpbnamdkip"
Waves Keeper - "lpilbniiabackdjcionkobglmddfbcjo"
Slope Finance - "pocmplpaccanhmnllbbkpgfliimjljgo"
ONTO - "ifckdpamphokdglkkdomedpdegcjhjdp"
Hiro - "ldinpeekobnhjjdofggfgjlcehhmanlj"
Plug - "cfbfdhimifdmdehjmkdobpcjfefblkjm"
Monsta - "hpbgcgmiemanfelegbndmhieiigkackl"
Guarda - "hpglfhgfnhbgpjdenjgmdgoeiappafln"
Exodus - "aholpfdialjgjfhomihkjbmgjidlcdno"
GameStop - "pkkjjapmlcncipeecdmlhaipahfdphkd"
BitKeep - "jiidiaalihmmhddjgbnbgdfflelocpak"
Rise - "hbbgbephgojikajhfbomhlmmollphcad"
Martian - "efbglgofoippbgcjepnhiblaibcnclgk"
Argent X - "dlcobpjiigpikoobohmabehhmhfoodbb"
SubWallet - "onhogfjeacnfoofkfgppdlbmlmnplgbn"
Fewcha - "ebfidpplhabeedpnhjnobghokpiioolj"
Petra Aptos - "ejjladinnckdgjemekebdpeokbikhfci"
Braavos - "jnlgamecbpmbajjfhmmmlhejkemejdma"
Braavos Edge - "hkkpjehhcnhgefhbdcgfkeegglpjchdc"
Nami - "lpfcbjknijpeeillifnkikgncikgfhdo"
ZilPay - "klnaejjgbibmhlephnhpmaofohgkpgkd"
Rabby - "acmacodkjbdgmoleebolmdjonilkdbch"
Harmony - "fnnegphlobjdpkhecapkijjdkgcjhkib"
MOBOX - "fcckkdbjnoikooededlapcalpionmalo"
Crust - "jccapkebeeiajkkdemacblkjhhhboiek"
Pali - "mgffkfbidihjpoaomajlbgchddlicgpn"
TON - "nphplpgoakhhjchkkhmiggakijnkhfnd"
Oasis - "ppdadbejkmjnefldpcdjhnkpbjkikoip"
Talisman - "fijngjgcjhjmmpcmkeiomlglpeiijkld"
Cosmostation - "fpkhgmpbidmiogeglndfbkegfdlnajnf"
Crypto.com - "hifafgmccdpekplomjjkcfgodnhcellj"
Crypto.com Edge - "gpbdhlngfkgihnfeekcmkbbalpdflgmg"
Stargazer - "pgiaagfkgcbnmiiolekcfmljdagdhlcm"
Ecto - "bgjogpoidejdemgoochpnkmdjpocgkha"
Fractal - "agechnindjilpccclelhlbjphbgnobpf"
BitClip - "ijmpgkjfkbfhoebgogflfebnmejmfbml"
Steem - "lkcjlnjfpbikmcmbachjpdbijejflpcm"
Nash - "onofpnbbkehpmmoabgpcpmigafmmnjhl"
Byone - "nlgbhdfgdhgbiamfdfmbikcdghidoadd"
Hycon Lite - "bcopgchhojmggmffilplmbdicgaihlkp"
GeroWallet - "bgpipimickeadkjlklgciifhnalhdjhe"
EVER - "cgeeodpfagjceefieflmdfphplkenlfk"
Earth - "agkfnefiabmfpanochlcakggnkdfmmjd"
Nabox - "nknhiehlklippafakaeklbeglecifhad"
X-Wallet - "bofddndhbegljegmpmnlbhcejofmjgbn"
Twetch - "jaooiolkmfcmloonphpiiogkfckgciom"
BOLT X - "aodkkagnadcbobfpggfnjeongemjbjca"
AlgoSigner - "kmmolakhbgdlpkjkcjkebenjheonagdm"
Tronium - "pnndplcbkakcplkjnolgbkdgjikjednm"
Equal - "blnieiiffboillknjnepogjhkgnoapac"
Nifty - "jbdaocneiiinmjbjlgalhcelgbejmnid"
Nightly - "fiikommddbeccaoicoejoniammnalkfa"
OneKey - "infeboajgfhgbjpjbeppbkgnabfdkdaf"
OneKey Edge - "obffkkagpmohennipjokmpllocnlndac"
Typhon - "kfdniefadaanbjodldohaedphafoffoh"
KHC - "hcflpincpppdclinealmandijcmnkbgn"
Jelly - "eegcfalgkkhehkhbjbggbhhlcnckadih"
TezBox - "mnfifefkajgofkcjkemidiaecocnkjeh"
PIP - "icblpoalghoakidcjiheabnkijnklhhe"
Ale - "cflgahhmjlmnjbikhakapcfkpbcmllam"
Zecrey - "ojbpcbinjmochkhelkflddfnmcceomdi"
ArConnect - "einnioafmpimabjcddiinlhmijaionap"
StarMask - "mfhbebgoclkghebffdldpobeajmbecfk"
HashPack - "gjagmgiddbbciopjhllkdnddhcglnemk"
KardiaChain - "pdadjkfkgcafgbceimcpbkalnfnepbnk"
Taho - "eajafomhmkipbjmfmhebemolkcicgfmd"
Pontem - "phkbamefinggmakgklpkljjmgibohnba"
Leap Terra - "aijcbedoijmgnlmjeegjaglmepbmpkpi"
Sender - "epapihdplajcdnnkdeiahlgigofloibg"
Surf - "emeeapjkbcbpbpgaagfchmcgglmebnen"
Leap Cosmos - "fcfcfllfndlomdhbehjjcoimbgofdncg"
HAVAH - "cnncmdhjacpkmjmkcafchppbnpnhdmon"
Eternl - "kmhcihpebfmpgmihbkipmjlmmioameka"
Finnie - "cjmkndjhnagcfbpiemnkdpomccnjblmj"
GuildWallet - "nanjmdknhkinifnkgdcggcfnhdaammmj"
Sui - "opcgpfmipidbgpenhmajoajpbobppdil"
Suiet - "khpkpbbcccdmmclmpigdgddabeilkdpd"
SenSui - "ebaeifdbcjklcmoigppnpkcghndhpbbm"
Glass - "loinekcabhlmhjjbocijdoimmejangoa"
Morphis - "heefohaffomkkkphnlpohglngmbcclhi"
Goby - "jnkelfanjkeadonecabehalmbgpfodjm"
Halo - "nbdpmlhambbdkhkmbfpljckjcmgibalo"
Polkadot.js - "mopnmbcafieddcagagdcbnhejhlodfdd"
Glow - "ojbcfhjmpigfobfclfflafhblgemeidi"
Glow Edge - "niihfokdlimbddhfmngnplgfcgpmlido"
Ethos Sui - "mcbigmjiafegjnnogedioegffbooigli"
Ethos Sui Edge - "kcgelamicebnalepkbppmoeiaaaljcee"
Fluent - "eokbbaidfgdndnljmffldfgjklpjkdoi"
Fluent Edge - "ldddehjcggepmlipdbempbnjehjehchh"
Casper - "abkahkcbhngaebpcgfmhkoioedceoigp"
CasperSigner - "djhndpllfiibmcdbnmaaahkhchcoijce"
Saturn - "nkddgncdjgjfcddamfgcmfnlhccnimig"
BitApp - "fihkakfobkmkjojpchpfgcmhfjnmnfpi"
Unisat - "ppbibelpcjmhbdihakflkdcoccbgbkpo"
MEW CX - "nlbmnnijcnlegkjjpcfjclmcfggfefdm"
Enkrypt - "chrome-extension_kkpllkodjeloidieedojogacfhpaihoh_0.indexeddb.leveldb"
Enkrypt Edge - "chrome-extension_gfenajajnjjmmdojhdjmnngomkhlnfjl_0.indexeddb.leveldb"
Yoroi - "chrome-extension_ffnbelfdoeiohenkjibnmadjiehjhajb_0.indexeddb.leveldb"
Yoroi Edge - "chrome-extension_akoiaibnepcedcplijmiamnaigbepmcb_0.indexeddb.leveldb"
Jaxx Liberty - "chrome-extension_cjelfplplebdjjenllpjcblmjkfcffne_0.indexeddb.leveldb"
Manta - "chrome-extension_enabgbdfcbaehmbigakijjabdpdnimlg_0.indexeddb.leveldb"


Collected application extensions:

TOTP Authenticator - "ibpjepoimpcdofeoalokgpjafnjonkpc"
2FA Authenticator - "gmohoglkppnemohbcgjakmgengkeaphi"
Open 2FA Authenticator - "dckgbiealcgdhgjofgcignfngijpbgba"
GAuth Authenticator - "ilgcnhelpchnceeipipijaljkblbcobl"
KeePassXC-Browser - "oboonakemofpalcgghocfoadofidjkkk"
Microsoft Autofill - "fiedbfgcleddlbcmgdigjgdfcggjcion"
iCloud Passwords - "pejdijmoenmkgeppbflobdenhhabjlaj"
iCloud Passwords Edge - "mfbcdcnpokpoajjciilocoachedjkima"
Dropbox Passwords - "bmhejbnmpamgfnomlahkonpanlkcfabg"
Dropbox Passwords Edge - "fpkmflnbcknhlogdhofdmneejiijefch"
NordPass - "fooolghllnmhmmndgjiamiiodkpenpbb"
DualSafe - "lgbjhdkjmpgjgcbcdlhkokkckpjmedgc"
DualSafe Edge - "bobgdmjpamhpbiobbklajbdkgmmmbcja"
Bitwarden - "nngceckbapebfimnlniiiahkandclblb"
Bitwarden Edge - "jbkfoedolllekgbhcbcoahefnbanhhlh"
KeePass Tusk - "fmhmiaejopepamlcjkncpgpdjichnecm"
Avira - "caljgklbbfbcjjanaijlacgncafpegll"
Avira Edge - "emgfgdclgfeldebanedpihppahgngnle"
LastPass - "hdokiejnpimakedhajhdlcegeplioahd"
LastPass Edge - "bbcinlkgjjkejfdpemiealijmmooekmp"
Dashlane - "fdjamakpfbbddfjaooikfcpapjohcfmg"
Dashlane Edge - "gehmmocbbkpblljhkekmfhjpfbkclbph"
TrueKey - "cpaibbcbodhimfnjnakiidgbpiehfgci"
TrueKey Edge - "gnnbmcifkkjgjdbkilfglpdpmidkgefn"
RoboForm - "pnlccmojcmeohlpggmfnbbiapkmbliob"
RoboForm Edge - "ljfpcifpgbbchoddpjefaipoiigpdmag"
Norton - "admmjipmmciaobhojoghlmleefbicajg"
Norton Edge - "lcccdlklhahfmobgpnilndimkankpnkg"
Keeper - "bfogiafebfohielmmehodmfbbebbbpei"
Keeper Edge - "lfochlioelphaglamdcakfjemolpichk"
Kee - "mmhlniccooihdimnnjhamobppdhaolme"
Kee Edge - "amfjccmjojpjginicahekljnhhjemjec"
ExpressVPN Keys - "blgcbajigpdfohpgcmbbfnphcgifjopc"
MultiPassword - "cnlhokffphohmfcddnibpohmkdfafdli"
ESET - "khhapgacijodhjokkcjmleaempmchlem"
ESET Edge - "keokhigifjinncljedmendkbikiakicj"
1Password - "aeblfdkhhhdcdjpifhhbdiojplfjncoa"
1Password Edge - "dppgmdbiimibapkepcbdbmkaabgiofem"
1Password Beta - "khgocmkkpikpnmmkgmdnfckapcdkgfaf"
Password Manager Pro - "hfdkpbblioghdghhkdppipefbchgpohn"
Enpass - "kmcfomidfpdkfieipokbalgegidffkal"
Enpass Edge - "mliehcloacfoicbanjhhnlimealolgoi"
SaasPass - "nhhldecdfagpbfggphklkaeiocfnaafm"
Passbolt - "didegimhafipceonhjepacocaffmoppf"
Passbolt Edge - "ljeppgjhohmhpbdhjjjbiflabdgfkhpo"
F-Secure - "hoinmffpdlgmkhckafddjleaelkdnhhk"
F-Secure Edge - "ljpdiapgjljgaiiilgojopoonfnnpfgj"
NextCloud - "mhajlicjhgoofheldnmollgbgjheenbi"
NextCloud Edge - "cjmlcljdpphgdfpkngjcmeepdpcgpffk"
Steganos - "flbkoklcepefekfcdjlabencimigaahd"
Steganos Edge - "gpfoagmiheifcpjodakdcjjfjlbbchhb"
Netwrix Password - "bpjfchmapbmjeklgmlkabfepflgfckip"
Netwrix Password Edge - "ahdfobpkkckhdhbmnpjehdkepaddfhek"
pCloud - "hldllnfgjbablcfcdcjldbbfopmohnda"
pCloud Edge - "ebiiomgikeochbjcbafgeapfmcfgapap"
Sticky Edge - "jbipmfkjgjhibkepepeneigpkfeikikp"
Kaspersky Edge - "eolheccophlcbnkkbelcgminoojochgj"
authenticator.cc - "bhghoamapcdpbohphigoooaddinpkbai"
authenticator.cc Edge - "ocglkepbibnalbgmbachknglpdipeoio"


